rusty | corroded | black | dirty | painted
brass | metal | wood | stone | plastic
spin | twirl | ache | sweat | flush
passage | hallway | ticket | entrance | room
yield | submit | challenge | boast | scorn
lean | rest | scrape | grate | refer
barrel | cask | bottle | box | case
nuisance | pest | garbage | relief | troublesome
rug | carpet | sofa | ottoman | hallway
tap | drain | boil | knock | rap
split | divided | crushed | grated | bruised
lump | chunk | stem | trunk | limb
outline | contour | pair | blend | block
swear | vow | explain | think | describe
relieved | rested | sleepy | tired | hasty
deserve | merit | need | want | expect
haste | a hurry | anger | ear | spite
stiff | firm | dark | drunk | cooked
verse | section | weed | twig | branch
steep | sheer | bare | rugged | stone
envious | jealous | enthusiastic  | hurt | relieved
paste | dough | syrup | block | jelly
scorn | refuse | enjoy | avoid | plan
refer | direct | call | carry | explain
limb | branch | bark  | trunk | twig
pad | cushion | board | block | tablet
boast | brag | yell | complain | explain
applause | approval | fear | shame | friends
sheet | leaf | book | block | tap
stem | stalk | bark | column | trunk
seize | take | refer | request | yield
trunk | chest | bag | closet | swing
weed | unwanted plant | cloth | animal | vegetable
approval | endorsement | gift | statement | confession
mass | lump | service | worship | element
swing | sway | bounce | break | crash
sore | painful | red | hot | rough
hinder | block | assist | relieve | yield
sticky | gooey | smooth | shiny | wet
confession | statement | service | plea | bargain
weave | intertwine | print | stamp | shake
saucer | dish | box | frisbee | can
substance | thing | posture | level | score
firmly | steadfastly | reluctantly | sadly | hopefully
twist | intertwine | clip | fasten | curl
scrape | grate | chop | mince | slice
grind | rub | slice | hit | tap
swell | enlarge | move | curl | shake
harvest | intake | stem | lump | split
approve | support | boast | scorn | anger
