enormously | tremendously | appropriately | uniquely | decidedly
provisions | stipulations | jurisdictions | interrelations | interpretations
haphazardly | randomly | linearly | dangerously | densely
prominent | conspicuous | ancient | mysterious | battered
zenith | pinnacle | completion | decline | outset
flawed | imperfect | tiny | crude | lustrous
urgently | desperately | conceivably | typically | tentatively
consumed | eaten | bred | caught | supplied
advent | coming | stability | financing | arrest
concisely | succinctly | freely | positively | powerfully
salutes | greetings | privileges | ceremonies | information
solitary | alone | fearless | alert | restless
hasten | accelerate | accompany | determine | permit
perseverance | endurance | skill | generosity | disturbance
fanciful | imaginative | logical | familiar | apparent
showed | demonstrated | published | repeated | postponed
constantly | continually | accidentally | rapidly | instantly
issues | subjects | training | benefits | salaries
furnish | supply | protect | advise | impress
costly | expensive | beautiful | popular | complicated
recognized | acknowledged | welcomed | depicted | successful
spot | location | climate | latitude | sea
make | earn | print | trade | borrow
often | frequently | definitely | chemically | hardly
easygoing | relaxed | boring | frontier | farming
debate | argument | competition | war | election
narrow | thin | poisonous | freezing | clear
arranged | planned | discarded | studied | explained
infinite | limitless | structural | unusual | relative
showy | striking | prickly | incidental | entertaining
levied | imposed | believed | correlated | requested
deftly | skillfully | occasionally | prudently | humorously
distribute | circulate | commercialize | acknowledge | research
discrepancies | differences | weights | wavelengths | deposits
prolific | productive | capable | serious | promising
unmatched | unequaled | emulated | alienated | unrecognized
peculiarly | uniquely | suspiciously | patriotically | partly
hue | color | contrast | scent | glare
hind | rear | curved | muscular | hairy
highlight | accentuate | alter | restore | imitate
hastily | hurriedly | habitually | shrewdly | chronologically
temperate | mild | short | windy | cold
grin | smile | exercise | rest | joke
verbally | orally | verbosely | overtly | fittingly
physician | doctor | chemist | nurse | pharmacist
essentially | basically | eagerly | ordinarily | possibly
keen | sharp | useful | simple | famous
situated | positioned | rotating | emptying | isolated
principal | major | exceptional | numerous | most
slowly | gradually | effectively | continuously | rarely
built | constructed | proposed | organized | financed
tasks | jobs | customers | shops | materials
unlikely | improbable | disagreeable | different | unpopular
halfheartedly | apathetically | unconventionally | bipartisanly | customarily
annals | chronicles | homes | trails | songs
wildly | furiously | mysteriously | abruptly | distinctively
hailed | acclaimed | judged | remembered | addressed
command | mastery | observation | love | awareness
concocted | devised | supervised | requested | cleaned
prospective | potential | prominent | particular | prudent
generally | broadly | controversially | accurately | descriptively
sustained | prolonged | analyzed | refined | lowered
perilous | dangerous | offensive | binding | exciting
tranquillity | peacefulness | weariness | harshness | happiness
dissipate | disperse | isolate | photograph | disguise
primarily | chiefly | consistently | occasionally | cautiously
colloquial | conversational | incorrect | recorded | misunderstood
resolved | settled | examined | forgotten | publicized
feasible | possible | evident | permitted | equitable
expeditiously | rapidly | frequently | repeatedly | actually
percentage | proportion | sample | profit | volume
terminated | ended | posed | evaluated | postponed
uniform | alike | sharp | hard | complex
figure | solve | list | express | divide
sufficient | enough | valuable | physiological | recent
fashion | manner | fathom | craze | ration
marketed | sold | sweetened | diluted | frozen
bigger | larger | steadier | closer | better
roots | origins | function | rituals | cure
normally | ordinarily | periodically | haltingly | permanently
